North Palace
48/14
{14;03}
292929292929292929292929292929292929292929292929292929292929292929292929292929292929292929292929
292929292929292929292929292929292929292929292929292929292929292929292929292929292929292929292929
151504151504151504151504151504151504151504151515151515041515041515041515041515041515041515041515
161605161605161605161605161605161605161605161616161616051616051616051616051616051616051616051616
000005000005000005000005000005000005000005000000000000050000050000050000050000050000050000050000
000005000005000005000005000005000005000005000000000000050000050000050000050000050000050000050000
000005000005000005000005000005000005000005000047480000050000050000050000050000050000050000050000
000005000005000005000005000005000005002929313131313131292900050000050000050000050000050000050000
000005000005000005000005000005000005292931313131313131312929050000050000050000050000050000050000
000005000005000005000005000005002929293131313131313131313129292900050000050000050000050000050000
303030303030303030303030303030303030303030303030303030303030303030303030303030303030303030303030
303030303030303030303030303030303030303030303030303030303030303030303030303030303030303030303030